25
55
06 06 06 06 06 06 06 06 06 06 06 06 06 06 06 06 06 06 06 06 06 06 06 06 06 06 06 06 06 06 28 28 28 28 28 28 28 28 01 01 01 01 01 01 01 01 01 01 01 01 01 01 01 01 01
06 06 06 06 06 06 06 06 06 06 06 06 06 06 06 06 06 06 06 06 06 06 06 06 06 06 06 06 06 06 06 06 28 28 28 28 28 28 01 01 01 01 01 01 01 01 01 01 01 01 01 01 01 01 01
06 06 00 00 00 00 00 00 00 00 00 00 00 00 00 00 00 00 00 00 00 00 00 00 00 00 00 00 06 06 28 28 28 28 28 28 28 28 01 01 00 00 00 00 00 00 00 00 00 00 00 00 00 00 01
06 06 00 00 00 00 00 00 00 00 00 00 00 00 00 00 00 00 00 00 00 00 00 00 00 00 00 00 06 06 06 06 28 28 28 28 28 01 01 01 00 00 00 36 36 36 00 00 00 00 00 00 00 00 01
06 06 00 00 00 00 00 00 00 00 00 00 00 00 00 00 00 00 00 36 36 36 36 36 36 36 36 00 06 06 06 06 06 06 01 01 01 01 01 01 00 00 00 36 36 36 00 00 00 00 00 00 00 00 01
06 06 06 06 06 06 06 06 06 06 06 06 06 06 06 06 06 06 00 36 00 00 06 11 00 00 36 00 00 00 00 00 00 00 00 00 00 00 00 00 00 00 00 00 00 00 00 00 00 00 00 00 00 00 01
06 06 13 13 13 13 13 13 13 13 13 13 13 13 13 13 13 13 00 36 00 00 06 11 00 00 36 00 00 00 00 00 00 00 00 00 00 00 00 00 00 00 00 00 00 00 00 00 00 00 00 00 00 00 01
06 06 00 00 00 00 00 00 00 00 36 36 36 00 00 36 36 36 36 36 36 00 06 11 00 00 36 00 00 00 00 00 00 00 00 00 00 00 00 00 00 00 00 00 00 00 00 00 00 00 00 00 00 00 01
06 06 00 18 18 18 18 19 19 19 36 36 36 36 36 36 36 36 36 36 36 00 06 11 00 00 36 00 00 03 03 03 03 03 03 03 03 03 03 03 03 03 03 03 03 03 03 03 03 03 03 03 03 03 03
06 06 00 00 25 26 36 36 36 36 36 36 36 17 17 36 36 36 36 36 36 00 06 11 00 00 36 00 00 03 03 03 03 03 03 03 03 03 03 03 03 03 03 03 03 03 03 03 03 03 03 03 03 03 03
06 06 36 36 36 36 36 00 29 00 36 36 36 17 17 36 36 14 36 36 36 00 06 11 00 00 36 00 00 00 00 00 00 00 00 00 00 00 00 00 00 00 00 00 00 00 00 00 00 00 00 00 00 00 02
06 06 21 22 21 22 36 30 31 32 36 00 27 27 27 36 36 14 36 36 36 00 06 11 00 36 36 00 00 00 00 00 00 00 00 00 00 00 00 00 00 00 00 00 00 00 00 00 00 00 00 00 00 00 02
06 06 23 24 23 24 36 33 34 35 36 36 20 20 20 36 36 14 36 36 00 00 06 11 00 36 00 00 00 00 00 00 00 00 00 00 00 00 00 00 00 00 00 00 00 00 00 00 00 00 00 00 00 00 02
06 06 36 36 36 36 36 36 36 36 36 36 00 00 00 36 36 14 36 36 00 00 06 11 00 36 00 00 00 00 00 00 00 00 00 00 02 02 02 02 02 02 02 02 02 02 02 02 02 00 00 00 00 00 02
28 28 00 00 00 00 00 00 16 16 16 16 16 16 00 36 36 14 36 36 00 00 06 11 00 36 00 00 00 00 00 00 00 00 00 00 02 02 02 02 02 02 02 02 02 02 02 02 02 00 00 00 00 00 02
28 28 00 00 00 15 15 00 16 16 16 16 16 16 00 36 36 14 36 36 00 00 06 11 00 36 00 00 02 02 02 02 02 02 02 02 02 02 02 02 02 02 02 02 02 02 02 02 02 02 02 02 02 02 02
28 28 00 00 00 15 15 36 36 36 36 36 36 36 36 36 36 14 36 36 00 00 06 11 00 36 00 00 02 02 02 02 02 02 02 02 02 02 02 02 02 02 02 02 02 02 02 02 02 02 02 02 02 02 02
28 28 00 00 36 15 15 08 08 08 08 08 08 08 08 08 08 08 36 36 00 00 06 11 00 36 00 00 02 00 00 00 00 00 00 00 00 00 00 00 00 00 00 00 00 00 00 00 00 00 00 28 28 28 28
07 07 00 00 36 15 15 08 08 08 08 08 08 08 08 08 08 08 36 36 00 00 06 11 00 36 36 00 02 00 00 00 00 00 00 00 00 00 36 36 36 36 00 00 00 36 36 36 36 00 00 28 28 28 28
07 07 00 00 36 15 15 08 08 08 08 08 08 08 08 08 08 08 00 36 00 00 00 00 00 00 36 00 02 00 00 00 00 00 00 00 00 00 36 36 00 00 28 28 28 00 00 36 36 00 00 28 28 28 28
07 07 00 00 36 36 36 36 36 00 00 08 08 28 28 08 08 14 00 36 00 00 00 00 00 00 36 00 00 00 00 28 28 28 28 28 00 00 36 36 00 00 28 28 28 00 00 36 36 00 00 28 28 28 28
07 07 00 00 00 00 00 00 36 00 00 10 10 28 28 08 10 00 00 36 00 02 02 02 02 00 36 00 00 00 00 28 28 28 28 28 00 00 36 36 00 00 28 28 28 00 00 36 36 00 00 28 28 28 28
07 07 00 00 00 00 00 00 36 00 00 10 10 28 28 10 10 00 36 36 00 02 02 02 02 00 36 00 00 00 00 28 28 28 28 28 00 00 36 36 00 00 28 28 28 00 00 36 36 00 00 28 28 28 28
07 07 00 00 00 00 00 00 36 00 00 10 10 28 28 10 10 00 36 36 00 02 28 28 02 00 36 00 02 00 00 00 00 00 00 00 00 00 36 36 00 00 28 28 28 00 00 36 36 00 00 28 28 28 28
07 07 07 07 07 07 07 07 07 07 28 28 28 28 28 28 28 28 28 02 02 28 28 02 02 02 02 02 02 02 02 02 02 02 02 02 02 02 02 02 02 02 02 02 02 02 02 02 02 02 02 02 02 02 02